NO ./path_to_the_north_texture/txtr.xpm

SO ./path_to_the_south_texture/txtr.xpm


WE        ./path_to_the_west_texture/txtr.xpm

F 22, 22, 22
C 211   ,     211,    211   

EA ./path_to_the_east_texture/txtr.xpm


        1111111111111111111111111
        1000000000110000000000001
        101100000111000000000000111
        100100000000000000000000001
11111111101100001110000000000000011  1
100000000011000001110111111111111   101
11110111111111011100000010001        1
11110111111111011101010010001
11000000110101011100000010001
10000000000000001100000010001
10000000000000000000100000001
11000001110101011111011110S0111
11110111 1110101 100011010001
11111111 1111111 111111111111
